id,intersection_id,road_order_id,turn_ratio_template_id
1,1,1,1
2,1,2,1
3,1,3,1
4,1,4,1
5,2,1,2
6,2,2,2
7,2,3,2
8,2,4,2
9,3,1,3
10,3,2,3
11,3,3,3
12,3,4,3
13,4,1,4
14,4,2,4
15,4,3,4
16,4,4,4
17,5,1,5
18,5,2,5
19,5,3,5
20,5,4,5
21,6,1,6
22,6,2,6
23,6,3,6
24,6,4,6
25,7,1,7
26,7,2,7
27,7,3,7
28,7,4,7
29,8,1,1
30,8,2,1
31,8,3,1
32,8,4,1
